A -> X
B -> Y
C -> Z
D -> 3
E -> M
F -> W
G -> Q
H -> P
I -> L
J -> V
K -> C
L -> D
M -> 7
N -> 8
O -> R
P -> T
Q -> U
R -> B
S -> A
T -> K
U -> O
V -> F
W -> G
X -> S
Y -> J
Z -> N
a -> x
b -> y
c -> z
d -> 3
e -> m
f -> w
g -> q
h -> p
i -> l
j -> v
k -> c
l -> d
m -> 7
n -> 8
o -> r
p -> t
q -> u
r -> b
s -> a
t -> k
u -> o
v -> f
w -> g
x -> s
y -> j
z -> n

